8 8
.##..##.
.#...###
.##..#..
..##....
#....##.
.....##.
.###....
...##...
